##########
#...@....#
####.###.#
#.#..#...#
#.#.##.###
#...##...#
#.######.#
#.#.......
#...######
##########