........................
....l.............l.....
..........E.............
.................l......
......l...@.............
........................
.l.........l.........l..
................l.......